+++++++++++
+A0Aa +   +
+ + + + + +
+ +a+ + + +
+ + +++ + +
+ + + + + +
+ + + + + +
+ + + + + +
+         +
+++++++++++