red: 0,A
green: 1,B
++++++++++++
+  0 d   +a+
+ ++++++++A+
+B  b   c  +
++++++++++ +
+1         +
++++++++++++
